prompt1	[a basket with an apple in the shape of a banana,a basket with a banana in the shape of an apple,a basket with an apple,a basket with a banana]
prompt2	[a basket with an apple in the shape of a cute cat,a basket with a cute cat in the shape of an apple,a basket with an apple,a basket with a cute cat]
prompt3	[a basket with an apple in the shape of a corgi dog,a basket with a corgi dog in the shape of an apple,a basket with an apple,a basket with a corgi dog]
prompt4	[a basket with an apple in the shape of a muffin,a basket with a muffin in the shape of an apple,a basket with an apple,a basket with a muffin]
prompt5	[a basket with a banana in the shape of a cute cat,a basket with a cute cat in the shape of a banana,a basket with a banana,a basket with a cute cat]
prompt6	[a basket with a banana in the shape of a corgi dog,a basket with a corgi dog in the shape of a banana,a basket with a banana,a basket with a corgi dog]
prompt7	[a basket with a banana in the shape of a muffin,a basket with a muffin in the shape of a banana,a basket with a banana,a basket with a muffin]
prompt8	[a basket with a cute cat in the shape of a corgi dog,a basket with a corgi dog in the shape of a cute cat,a basket with a cute cat,a basket with a corgi dog]
prompt9	[a basket with a cute cat in the shape of a muffin,a basket with a muffin in the shape of a cute cat,a basket with a cute cat,a basket with a muffin]
prompt10	[a basket with a corgi dog in the shape of a muffin,a basket with a muffin in the shape of a corgi dog,a basket with a corgi dog,a basket with a muffin]
prompt11	[a teapot with an apple in the shape of a banana,a teapot with a banana in the shape of an apple,a teapot with an apple,a teapot with a banana]
prompt12	[a teapot with an apple in the shape of a cute cat,a teapot with a cute cat in the shape of an apple,a teapot with an apple,a teapot with a cute cat]
prompt13	[a teapot with an apple in the shape of a corgi dog,a teapot with a corgi dog in the shape of an apple,a teapot with an apple,a teapot with a corgi dog]
prompt14	[a teapot with an apple in the shape of a muffin,a teapot with a muffin in the shape of an apple,a teapot with an apple,a teapot with a muffin]
prompt15	[a teapot with a banana in the shape of a cute cat,a teapot with a cute cat in the shape of a banana,a teapot with a banana,a teapot with a cute cat]
prompt16	[a teapot with a banana in the shape of a corgi dog,a teapot with a corgi dog in the shape of a banana,a teapot with a banana,a teapot with a corgi dog]
prompt17	[a teapot with a banana in the shape of a muffin,a teapot with a muffin in the shape of a banana,a teapot with a banana,a teapot with a muffin]
prompt18	[a teapot with a cute cat in the shape of a corgi dog,a teapot with a corgi dog in the shape of a cute cat,a teapot with a cute cat,a teapot with a corgi dog]
prompt19	[a teapot with a cute cat in the shape of a muffin,a teapot with a muffin in the shape of a cute cat,a teapot with a cute cat,a teapot with a muffin]
prompt20	[a teapot with a corgi dog in the shape of a muffin,a teapot with a muffin in the shape of a corgi dog,a teapot with a corgi dog,a teapot with a muffin]
prompt21	[a basket in the shape of a teapot with an apple,a teapot in the shape of a teapot with an apple,a basket with an apple,a teapot with an apple]
prompt22	[a basket in the shape of a teapot with a banana,a teapot in the shape of a teapot with a banana,a basket with a banana,a teapot with a banana]
prompt23	[a basket in the shape of a teapot with a cute cat,a teapot in the shape of a teapot with a cute cat,a basket with a cute cat,a teapot with a cute cat]
prompt24	[a basket in the shape of a teapot with a corgi dog,a teapot in the shape of a teapot with a corgi dog,a basket with a corgi dog,a teapot with a corgi dog]
prompt25	[a basket in the shape of a teapot with a muffin,a teapot in the shape of a teapot with a muffin,a basket with a muffin,a teapot with a muffin]
prompt26	[an apple in the shape of a banana on a table,a banana in the shape of an apple on a table,an apple on a table,a banana on a table]
prompt27	[an apple in the shape of a cute cat on a table,a cute cat in the shape of an apple on a table,an apple on a table,a cute cat on a table]
prompt28	[an apple in the shape of a corgi dog on a table,a corgi dog in the shape of an apple on a table,an apple on a table,a corgi dog on a table]
prompt29	[an apple in the shape of a muffin on a table,a muffin in the shape of an apple on a table,an apple on a table,a muffin on a table]
prompt30	[a banana in the shape of a cute cat on a table,a cute cat in the shape of a banana on a table,a banana on a table,a cute cat on a table]
prompt31	[a banana in the shape of a corgi dog on a table,a corgi dog in the shape of a banana on a table,a banana on a table,a corgi dog on a table]
prompt32	[a banana in the shape of a muffin on a table,a muffin in the shape of a banana on a table,a banana on a table,a muffin on a table]
prompt33	[a cute cat in the shape of a corgi dog on a table,a corgi dog in the shape of a cute cat on a table,a cute cat on a table,a corgi dog on a table]
prompt34	[a cute cat in the shape of a muffin on a table,a muffin in the shape of a cute cat on a table,a cute cat on a table,a muffin on a table]
prompt35	[a corgi dog in the shape of a muffin on a table,a muffin in the shape of a corgi dog on a table,a corgi dog on a table,a muffin on a table]
prompt36	[an apple in the shape of a banana on a bed,a banana in the shape of an apple on a bed,an apple on a bed,a banana on a bed]
prompt37	[an apple in the shape of a cute cat on a bed,a cute cat in the shape of an apple on a bed,an apple on a bed,a cute cat on a bed]
prompt38	[an apple in the shape of a corgi dog on a bed,a corgi dog in the shape of an apple on a bed,an apple on a bed,a corgi dog on a bed]
prompt39	[an apple in the shape of a muffin on a bed,a muffin in the shape of an apple on a bed,an apple on a bed,a muffin on a bed]
prompt40	[a banana in the shape of a cute cat on a bed,a cute cat in the shape of a banana on a bed,a banana on a bed,a cute cat on a bed]
prompt41	[a banana in the shape of a corgi dog on a bed,a corgi dog in the shape of a banana on a bed,a banana on a bed,a corgi dog on a bed]
prompt42	[a banana in the shape of a muffin on a bed,a muffin in the shape of a banana on a bed,a banana on a bed,a muffin on a bed]
prompt43	[a cute cat in the shape of a corgi dog on a bed,a corgi dog in the shape of a cute cat on a bed,a cute cat on a bed,a corgi dog on a bed]
prompt44	[a cute cat in the shape of a muffin on a bed,a muffin in the shape of a cute cat on a bed,a cute cat on a bed,a muffin on a bed]
prompt45	[a corgi dog in the shape of a muffin on a bed,a muffin in the shape of a corgi dog on a bed,a corgi dog on a bed,a muffin on a bed]
prompt46	[an apple in the shape of a banana on a carpet,a banana in the shape of an apple on a carpet,an apple on a carpet,a banana on a carpet]
prompt47	[an apple in the shape of a cute cat on a carpet,a cute cat in the shape of an apple on a carpet,an apple on a carpet,a cute cat on a carpet]
prompt48	[an apple in the shape of a corgi dog on a carpet,a corgi dog in the shape of an apple on a carpet,an apple on a carpet,a corgi dog on a carpet]
prompt49	[an apple in the shape of a muffin on a carpet,a muffin in the shape of an apple on a carpet,an apple on a carpet,a muffin on a carpet]
prompt50	[a banana in the shape of a cute cat on a carpet,a cute cat in the shape of a banana on a carpet,a banana on a carpet,a cute cat on a carpet]
prompt51	[a banana in the shape of a corgi dog on a carpet,a corgi dog in the shape of a banana on a carpet,a banana on a carpet,a corgi dog on a carpet]
prompt52	[a banana in the shape of a muffin on a carpet,a muffin in the shape of a banana on a carpet,a banana on a carpet,a muffin on a carpet]
prompt53	[a cute cat in the shape of a corgi dog on a carpet,a corgi dog in the shape of a cute cat on a carpet,a cute cat on a carpet,a corgi dog on a carpet]
prompt54	[a cute cat in the shape of a muffin on a carpet,a muffin in the shape of a cute cat on a carpet,a cute cat on a carpet,a muffin on a carpet]
prompt55	[a corgi dog in the shape of a muffin on a carpet,a muffin in the shape of a corgi dog on a carpet,a corgi dog on a carpet,a muffin on a carpet]
prompt56	[an apple on a table in the shape of a bed,an apple on a bed in the shape of a table,an apple on a table,an apple on a bed]
prompt57	[an apple on a table in the shape of a carpet,an apple on a carpet in the shape of a table,an apple on a table,an apple on a carpet]
prompt58	[an apple on a bed in the shape of a carpet,an apple on a carpet in the shape of a bed,an apple on a bed,an apple on a carpet]
prompt59	[a banana on a table in the shape of a bed,a banana on a bed in the shape of a table,a banana on a table,a banana on a bed]
prompt60	[a banana on a table in the shape of a carpet,a banana on a carpet in the shape of a table,a banana on a table,a banana on a carpet]
prompt61	[a banana on a bed in the shape of a carpet,a banana on a carpet in the shape of a bed,a banana on a bed,a banana on a carpet]
prompt62	[a cute cat on a table in the shape of a bed,a cute cat on a bed in the shape of a table,a cute cat on a table,a cute cat on a bed]
prompt63	[a cute cat on a table in the shape of a carpet,a cute cat on a carpet in the shape of a table,a cute cat on a table,a cute cat on a carpet]
prompt64	[a cute cat on a bed in the shape of a carpet,a cute cat on a carpet in the shape of a bed,a cute cat on a bed,a cute cat on a carpet]
prompt65	[a corgi dog on a table in the shape of a bed,a corgi dog on a bed in the shape of a table,a corgi dog on a table,a corgi dog on a bed]
prompt66	[a corgi dog on a table in the shape of a carpet,a corgi dog on a carpet in the shape of a table,a corgi dog on a table,a corgi dog on a carpet]
prompt67	[a corgi dog on a bed in the shape of a carpet,a corgi dog on a carpet in the shape of a bed,a corgi dog on a bed,a corgi dog on a carpet]
prompt68	[a muffin on a table in the shape of a bed,a muffin on a bed in the shape of a table,a muffin on a table,a muffin on a bed]
prompt69	[a muffin on a table in the shape of a carpet,a muffin on a carpet in the shape of a table,a muffin on a table,a muffin on a carpet]
prompt70	[a muffin on a bed in the shape of a carpet,a muffin on a carpet in the shape of a bed,a muffin on a bed,a muffin on a carpet]
prompt71	[a cute cat in the shape of a corgi dog in a bathtub,a corgi dog in the shape of a cute cat in a bathtub,a corgi dog in a bathtub, a cute cat in a bathtub']
