prompt1	[a kangaroo in the shape of a cute cat walking in Times Square,a cute cat in the shape of a kangaroo walking in Times Square,a kangaroo walking in Times Square,a cute cat walking in Times Square]
prompt2	[a kangaroo in the shape of a corgi dog walking in Times Square,a corgi dog in the shape of a kangaroo walking in Times Square,a kangaroo walking in Times Square,a corgi dog walking in Times Square]
prompt3	[a kangaroo in the shape of a parrot walking in Times Square,a parrot in the shape of a kangaroo walking in Times Square,a kangaroo walking in Times Square,a parrot walking in Times Square]
prompt4	[a kangaroo in the shape of a teddy bear walking in Times Square,a teddy bear in the shape of a kangaroo walking in Times Square,a kangaroo walking in Times Square,a teddy bear walking in Times Square]
prompt5	[a kangaroo in the shape of a penguin walking in Times Square,a penguin in the shape of a kangaroo walking in Times Square,a kangaroo walking in Times Square,a penguin walking in Times Square]
prompt6	[a cute cat in the shape of a corgi dog walking in Times Square,a corgi dog in the shape of a cute cat walking in Times Square,a cute cat walking in Times Square,a corgi dog walking in Times Square]
prompt7	[a cute cat in the shape of a parrot walking in Times Square,a parrot in the shape of a cute cat walking in Times Square,a cute cat walking in Times Square,a parrot walking in Times Square]
prompt8	[a cute cat in the shape of a teddy bear walking in Times Square,a teddy bear in the shape of a cute cat walking in Times Square,a cute cat walking in Times Square,a teddy bear walking in Times Square]
prompt9	[a cute cat in the shape of a penguin walking in Times Square,a penguin in the shape of a cute cat walking in Times Square,a cute cat walking in Times Square,a penguin walking in Times Square]
prompt10	[a corgi dog in the shape of a parrot walking in Times Square,a parrot in the shape of a corgi dog walking in Times Square,a corgi dog walking in Times Square,a parrot walking in Times Square]
prompt11	[a corgi dog in the shape of a teddy bear walking in Times Square,a teddy bear in the shape of a corgi dog walking in Times Square,a corgi dog walking in Times Square,a teddy bear walking in Times Square]
prompt12	[a corgi dog in the shape of a penguin walking in Times Square,a penguin in the shape of a corgi dog walking in Times Square,a corgi dog walking in Times Square,a penguin walking in Times Square]
prompt13	[a parrot in the shape of a teddy bear walking in Times Square,a teddy bear in the shape of a parrot walking in Times Square,a parrot walking in Times Square,a teddy bear walking in Times Square]
prompt14	[a parrot in the shape of a penguin walking in Times Square,a penguin in the shape of a parrot walking in Times Square,a parrot walking in Times Square,a penguin walking in Times Square]
prompt15	[a teddy bear in the shape of a penguin walking in Times Square,a penguin in the shape of a teddy bear walking in Times Square,a teddy bear walking in Times Square,a penguin walking in Times Square]
prompt16	[a kangaroo in the shape of a cute cat skiing in Times Square,a cute cat in the shape of a kangaroo skiing in Times Square,a kangaroo skiing in Times Square,a cute cat skiing in Times Square]
prompt17	[a kangaroo in the shape of a corgi dog skiing in Times Square,a corgi dog in the shape of a kangaroo skiing in Times Square,a kangaroo skiing in Times Square,a corgi dog skiing in Times Square]
prompt18	[a kangaroo in the shape of a parrot skiing in Times Square,a parrot in the shape of a kangaroo skiing in Times Square,a kangaroo skiing in Times Square,a parrot skiing in Times Square]
prompt19	[a kangaroo in the shape of a teddy bear skiing in Times Square,a teddy bear in the shape of a kangaroo skiing in Times Square,a kangaroo skiing in Times Square,a teddy bear skiing in Times Square]
prompt20	[a kangaroo in the shape of a penguin skiing in Times Square,a penguin in the shape of a kangaroo skiing in Times Square,a kangaroo skiing in Times Square,a penguin skiing in Times Square]
prompt21	[a cute cat in the shape of a corgi dog skiing in Times Square,a corgi dog in the shape of a cute cat skiing in Times Square,a cute cat skiing in Times Square,a corgi dog skiing in Times Square]
prompt22	[a cute cat in the shape of a parrot skiing in Times Square,a parrot in the shape of a cute cat skiing in Times Square,a cute cat skiing in Times Square,a parrot skiing in Times Square]
prompt23	[a cute cat in the shape of a teddy bear skiing in Times Square,a teddy bear in the shape of a cute cat skiing in Times Square,a cute cat skiing in Times Square,a teddy bear skiing in Times Square]
prompt24	[a cute cat in the shape of a penguin skiing in Times Square,a penguin in the shape of a cute cat skiing in Times Square,a cute cat skiing in Times Square,a penguin skiing in Times Square]
prompt25	[a corgi dog in the shape of a parrot skiing in Times Square,a parrot in the shape of a corgi dog skiing in Times Square,a corgi dog skiing in Times Square,a parrot skiing in Times Square]
prompt26	[a corgi dog in the shape of a teddy bear skiing in Times Square,a teddy bear in the shape of a corgi dog skiing in Times Square,a corgi dog skiing in Times Square,a teddy bear skiing in Times Square]
prompt27	[a corgi dog in the shape of a penguin skiing in Times Square,a penguin in the shape of a corgi dog skiing in Times Square,a corgi dog skiing in Times Square,a penguin skiing in Times Square]
prompt28	[a parrot in the shape of a teddy bear skiing in Times Square,a teddy bear in the shape of a parrot skiing in Times Square,a parrot skiing in Times Square,a teddy bear skiing in Times Square]
prompt29	[a parrot in the shape of a penguin skiing in Times Square,a penguin in the shape of a parrot skiing in Times Square,a parrot skiing in Times Square,a penguin skiing in Times Square]
prompt30	[a teddy bear in the shape of a penguin skiing in Times Square,a penguin in the shape of a teddy bear skiing in Times Square,a teddy bear skiing in Times Square,a penguin skiing in Times Square]
prompt31	[a kangaroo in the shape of a cute cat walking in a beautiful garden,a cute cat in the shape of a kangaroo walking in a beautiful garden,a kangaroo walking in a beautiful garden,a cute cat walking in a beautiful garden]
prompt32	[a kangaroo in the shape of a corgi dog walking in a beautiful garden,a corgi dog in the shape of a kangaroo walking in a beautiful garden,a kangaroo walking in a beautiful garden,a corgi dog walking in a beautiful garden]
prompt33	[a kangaroo in the shape of a parrot walking in a beautiful garden,a parrot in the shape of a kangaroo walking in a beautiful garden,a kangaroo walking in a beautiful garden,a parrot walking in a beautiful garden]
prompt34	[a kangaroo in the shape of a teddy bear walking in a beautiful garden,a teddy bear in the shape of a kangaroo walking in a beautiful garden,a kangaroo walking in a beautiful garden,a teddy bear walking in a beautiful garden]
prompt35	[a kangaroo in the shape of a penguin walking in a beautiful garden,a penguin in the shape of a kangaroo walking in a beautiful garden,a kangaroo walking in a beautiful garden,a penguin walking in a beautiful garden]
prompt36	[a cute cat in the shape of a corgi dog walking in a beautiful garden,a corgi dog in the shape of a cute cat walking in a beautiful garden,a cute cat walking in a beautiful garden,a corgi dog walking in a beautiful garden]
prompt37	[a cute cat in the shape of a parrot walking in a beautiful garden,a parrot in the shape of a cute cat walking in a beautiful garden,a cute cat walking in a beautiful garden,a parrot walking in a beautiful garden]
prompt38	[a cute cat in the shape of a teddy bear walking in a beautiful garden,a teddy bear in the shape of a cute cat walking in a beautiful garden,a cute cat walking in a beautiful garden,a teddy bear walking in a beautiful garden]
prompt39	[a cute cat in the shape of a penguin walking in a beautiful garden,a penguin in the shape of a cute cat walking in a beautiful garden,a cute cat walking in a beautiful garden,a penguin walking in a beautiful garden]
prompt40	[a corgi dog in the shape of a parrot walking in a beautiful garden,a parrot in the shape of a corgi dog walking in a beautiful garden,a corgi dog walking in a beautiful garden,a parrot walking in a beautiful garden]
prompt41	[a corgi dog in the shape of a teddy bear walking in a beautiful garden,a teddy bear in the shape of a corgi dog walking in a beautiful garden,a corgi dog walking in a beautiful garden,a teddy bear walking in a beautiful garden]
prompt42	[a corgi dog in the shape of a penguin walking in a beautiful garden,a penguin in the shape of a corgi dog walking in a beautiful garden,a corgi dog walking in a beautiful garden,a penguin walking in a beautiful garden]
prompt43	[a parrot in the shape of a teddy bear walking in a beautiful garden,a teddy bear in the shape of a parrot walking in a beautiful garden,a parrot walking in a beautiful garden,a teddy bear walking in a beautiful garden]
prompt44	[a parrot in the shape of a penguin walking in a beautiful garden,a penguin in the shape of a parrot walking in a beautiful garden,a parrot walking in a beautiful garden,a penguin walking in a beautiful garden]
prompt45	[a teddy bear in the shape of a penguin walking in a beautiful garden,a penguin in the shape of a teddy bear walking in a beautiful garden,a teddy bear walking in a beautiful garden,a penguin walking in a beautiful garden]
prompt46	[a kangaroo in the shape of a cute cat surfing on the beach,a cute cat in the shape of a kangaroo surfing on the beach,a kangaroo surfing on the beach,a cute cat surfing on the beach]
prompt47	[a kangaroo in the shape of a corgi dog surfing on the beach,a corgi dog in the shape of a kangaroo surfing on the beach,a kangaroo surfing on the beach,a corgi dog surfing on the beach]
prompt48	[a kangaroo in the shape of a parrot surfing on the beach,a parrot in the shape of a kangaroo surfing on the beach,a kangaroo surfing on the beach,a parrot surfing on the beach]
prompt49	[a kangaroo in the shape of a teddy bear surfing on the beach,a teddy bear in the shape of a kangaroo surfing on the beach,a kangaroo surfing on the beach,a teddy bear surfing on the beach]
prompt50	[a kangaroo in the shape of a penguin surfing on the beach,a penguin in the shape of a kangaroo surfing on the beach,a kangaroo surfing on the beach,a penguin surfing on the beach]
prompt51	[a cute cat in the shape of a corgi dog surfing on the beach,a corgi dog in the shape of a cute cat surfing on the beach,a cute cat surfing on the beach,a corgi dog surfing on the beach]
prompt52	[a cute cat in the shape of a parrot surfing on the beach,a parrot in the shape of a cute cat surfing on the beach,a cute cat surfing on the beach,a parrot surfing on the beach]
prompt53	[a cute cat in the shape of a teddy bear surfing on the beach,a teddy bear in the shape of a cute cat surfing on the beach,a cute cat surfing on the beach,a teddy bear surfing on the beach]
prompt54	[a cute cat in the shape of a penguin surfing on the beach,a penguin in the shape of a cute cat surfing on the beach,a cute cat surfing on the beach,a penguin surfing on the beach]
prompt55	[a corgi dog in the shape of a parrot surfing on the beach,a parrot in the shape of a corgi dog surfing on the beach,a corgi dog surfing on the beach,a parrot surfing on the beach]
prompt56	[a corgi dog in the shape of a teddy bear surfing on the beach,a teddy bear in the shape of a corgi dog surfing on the beach,a corgi dog surfing on the beach,a teddy bear surfing on the beach]
prompt57	[a corgi dog in the shape of a penguin surfing on the beach,a penguin in the shape of a corgi dog surfing on the beach,a corgi dog surfing on the beach,a penguin surfing on the beach]
prompt58	[a parrot in the shape of a teddy bear surfing on the beach,a teddy bear in the shape of a parrot surfing on the beach,a parrot surfing on the beach,a teddy bear surfing on the beach]
prompt59	[a parrot in the shape of a penguin surfing on the beach,a penguin in the shape of a parrot surfing on the beach,a parrot surfing on the beach,a penguin surfing on the beach]
prompt60	[a teddy bear in the shape of a penguin surfing on the beach,a penguin in the shape of a teddy bear surfing on the beach,a teddy bear surfing on the beach,a penguin surfing on the beach]
prompt61	[a kangaroo in the shape of a cute cat eating watermelon on the beach,a cute cat in the shape of a kangaroo eating watermelon on the beach,a kangaroo eating watermelon on the beach,a cute cat eating watermelon on the beach]
prompt62	[a kangaroo in the shape of a corgi dog eating watermelon on the beach,a corgi dog in the shape of a kangaroo eating watermelon on the beach,a kangaroo eating watermelon on the beach,a corgi dog eating watermelon on the beach]
prompt63	[a kangaroo in the shape of a parrot eating watermelon on the beach,a parrot in the shape of a kangaroo eating watermelon on the beach,a kangaroo eating watermelon on the beach,a parrot eating watermelon on the beach]
prompt64	[a kangaroo in the shape of a teddy bear eating watermelon on the beach,a teddy bear in the shape of a kangaroo eating watermelon on the beach,a kangaroo eating watermelon on the beach,a teddy bear eating watermelon on the beach]
prompt65	[a kangaroo in the shape of a penguin eating watermelon on the beach,a penguin in the shape of a kangaroo eating watermelon on the beach,a kangaroo eating watermelon on the beach,a penguin eating watermelon on the beach]
prompt66	[a cute cat in the shape of a corgi dog eating watermelon on the beach,a corgi dog in the shape of a cute cat eating watermelon on the beach,a cute cat eating watermelon on the beach,a corgi dog eating watermelon on the beach]
prompt67	[a cute cat in the shape of a parrot eating watermelon on the beach,a parrot in the shape of a cute cat eating watermelon on the beach,a cute cat eating watermelon on the beach,a parrot eating watermelon on the beach]
prompt68	[a cute cat in the shape of a teddy bear eating watermelon on the beach,a teddy bear in the shape of a cute cat eating watermelon on the beach,a cute cat eating watermelon on the beach,a teddy bear eating watermelon on the beach]
prompt69	[a cute cat in the shape of a penguin eating watermelon on the beach,a penguin in the shape of a cute cat eating watermelon on the beach,a cute cat eating watermelon on the beach,a penguin eating watermelon on the beach]
prompt70	[a corgi dog in the shape of a parrot eating watermelon on the beach,a parrot in the shape of a corgi dog eating watermelon on the beach,a corgi dog eating watermelon on the beach,a parrot eating watermelon on the beach]
prompt71	[a corgi dog in the shape of a teddy bear eating watermelon on the beach,a teddy bear in the shape of a corgi dog eating watermelon on the beach,a corgi dog eating watermelon on the beach,a teddy bear eating watermelon on the beach]
prompt72	[a corgi dog in the shape of a penguin eating watermelon on the beach,a penguin in the shape of a corgi dog eating watermelon on the beach,a corgi dog eating watermelon on the beach,a penguin eating watermelon on the beach]
prompt73	[a parrot in the shape of a teddy bear eating watermelon on the beach,a teddy bear in the shape of a parrot eating watermelon on the beach,a parrot eating watermelon on the beach,a teddy bear eating watermelon on the beach]
prompt74	[a parrot in the shape of a penguin eating watermelon on the beach,a penguin in the shape of a parrot eating watermelon on the beach,a parrot eating watermelon on the beach,a penguin eating watermelon on the beach]
prompt75	[a teddy bear in the shape of a penguin eating watermelon on the beach,a penguin in the shape of a teddy bear eating watermelon on the beach,a teddy bear eating watermelon on the beach,a penguin eating watermelon on the beach]
prompt76	[a kangaroo in the shape of a cute cat sitting on a sofa on the beach,a cute cat in the shape of a kangaroo sitting on a sofa on the beach,a kangaroo sitting on a sofa on the beach,a cute cat sitting on a sofa on the beach]
prompt77	[a kangaroo in the shape of a corgi dog sitting on a sofa on the beach,a corgi dog in the shape of a kangaroo sitting on a sofa on the beach,a kangaroo sitting on a sofa on the beach,a corgi dog sitting on a sofa on the beach]
prompt78	[a kangaroo in the shape of a parrot sitting on a sofa on the beach,a parrot in the shape of a kangaroo sitting on a sofa on the beach,a kangaroo sitting on a sofa on the beach,a parrot sitting on a sofa on the beach]
prompt79	[a kangaroo in the shape of a teddy bear sitting on a sofa on the beach,a teddy bear in the shape of a kangaroo sitting on a sofa on the beach,a kangaroo sitting on a sofa on the beach,a teddy bear sitting on a sofa on the beach]
prompt80	[a kangaroo in the shape of a penguin sitting on a sofa on the beach,a penguin in the shape of a kangaroo sitting on a sofa on the beach,a kangaroo sitting on a sofa on the beach,a penguin sitting on a sofa on the beach]
prompt81	[a cute cat in the shape of a corgi dog sitting on a sofa on the beach,a corgi dog in the shape of a cute cat sitting on a sofa on the beach,a cute cat sitting on a sofa on the beach,a corgi dog sitting on a sofa on the beach]
prompt82	[a cute cat in the shape of a parrot sitting on a sofa on the beach,a parrot in the shape of a cute cat sitting on a sofa on the beach,a cute cat sitting on a sofa on the beach,a parrot sitting on a sofa on the beach]
prompt83	[a cute cat in the shape of a teddy bear sitting on a sofa on the beach,a teddy bear in the shape of a cute cat sitting on a sofa on the beach,a cute cat sitting on a sofa on the beach,a teddy bear sitting on a sofa on the beach]
prompt84	[a cute cat in the shape of a penguin sitting on a sofa on the beach,a penguin in the shape of a cute cat sitting on a sofa on the beach,a cute cat sitting on a sofa on the beach,a penguin sitting on a sofa on the beach]
prompt85	[a corgi dog in the shape of a parrot sitting on a sofa on the beach,a parrot in the shape of a corgi dog sitting on a sofa on the beach,a corgi dog sitting on a sofa on the beach,a parrot sitting on a sofa on the beach]
prompt86	[a corgi dog in the shape of a teddy bear sitting on a sofa on the beach,a teddy bear in the shape of a corgi dog sitting on a sofa on the beach,a corgi dog sitting on a sofa on the beach,a teddy bear sitting on a sofa on the beach]
prompt87	[a corgi dog in the shape of a penguin sitting on a sofa on the beach,a penguin in the shape of a corgi dog sitting on a sofa on the beach,a corgi dog sitting on a sofa on the beach,a penguin sitting on a sofa on the beach]
prompt88	[a parrot in the shape of a teddy bear sitting on a sofa on the beach,a teddy bear in the shape of a parrot sitting on a sofa on the beach,a parrot sitting on a sofa on the beach,a teddy bear sitting on a sofa on the beach]
prompt89	[a parrot in the shape of a penguin sitting on a sofa on the beach,a penguin in the shape of a parrot sitting on a sofa on the beach,a parrot sitting on a sofa on the beach,a penguin sitting on a sofa on the beach]
prompt90	[a teddy bear in the shape of a penguin sitting on a sofa on the beach,a penguin in the shape of a teddy bear sitting on a sofa on the beach,a teddy bear sitting on a sofa on the beach,a penguin sitting on a sofa on the beach]
prompt91	[a kangaroo in the shape of a cute cat watching northern lights,a cute cat in the shape of a kangaroo watching northern lights,a kangaroo watching northern lights,a cute cat watching northern lights]
prompt92	[a kangaroo in the shape of a corgi dog watching northern lights,a corgi dog in the shape of a kangaroo watching northern lights,a kangaroo watching northern lights,a corgi dog watching northern lights]
prompt93	[a kangaroo in the shape of a parrot watching northern lights,a parrot in the shape of a kangaroo watching northern lights,a kangaroo watching northern lights,a parrot watching northern lights]
prompt94	[a kangaroo in the shape of a teddy bear watching northern lights,a teddy bear in the shape of a kangaroo watching northern lights,a kangaroo watching northern lights,a teddy bear watching northern lights]
prompt95	[a kangaroo in the shape of a penguin watching northern lights,a penguin in the shape of a kangaroo watching northern lights,a kangaroo watching northern lights,a penguin watching northern lights]
prompt96	[a cute cat in the shape of a corgi dog watching northern lights,a corgi dog in the shape of a cute cat watching northern lights,a cute cat watching northern lights,a corgi dog watching northern lights]
prompt97	[a cute cat in the shape of a parrot watching northern lights,a parrot in the shape of a cute cat watching northern lights,a cute cat watching northern lights,a parrot watching northern lights]
prompt98	[a cute cat in the shape of a teddy bear watching northern lights,a teddy bear in the shape of a cute cat watching northern lights,a cute cat watching northern lights,a teddy bear watching northern lights]
prompt99	[a cute cat in the shape of a penguin watching northern lights,a penguin in the shape of a cute cat watching northern lights,a cute cat watching northern lights,a penguin watching northern lights]
prompt100	[a corgi dog in the shape of a parrot watching northern lights,a parrot in the shape of a corgi dog watching northern lights,a corgi dog watching northern lights,a parrot watching northern lights]
prompt101	[a corgi dog in the shape of a teddy bear watching northern lights,a teddy bear in the shape of a corgi dog watching northern lights,a corgi dog watching northern lights,a teddy bear watching northern lights]
prompt102	[a corgi dog in the shape of a penguin watching northern lights,a penguin in the shape of a corgi dog watching northern lights,a corgi dog watching northern lights,a penguin watching northern lights]
prompt103	[a parrot in the shape of a teddy bear watching northern lights,a teddy bear in the shape of a parrot watching northern lights,a parrot watching northern lights,a teddy bear watching northern lights]
prompt104	[a parrot in the shape of a penguin watching northern lights,a penguin in the shape of a parrot watching northern lights,a parrot watching northern lights,a penguin watching northern lights]
prompt105	[a teddy bear in the shape of a penguin watching northern lights,a penguin in the shape of a teddy bear watching northern lights,a teddy bear watching northern lights,a penguin watching northern lights]
prompt106	[a kangaroo in the shape of a cute cat watching sunset at a beach,a cute cat in the shape of a kangaroo watching sunset at a beach,a kangaroo watching sunset at a beach,a cute cat watching sunset at a beach]
prompt107	[a kangaroo in the shape of a corgi dog watching sunset at a beach,a corgi dog in the shape of a kangaroo watching sunset at a beach,a kangaroo watching sunset at a beach,a corgi dog watching sunset at a beach]
prompt108	[a kangaroo in the shape of a parrot watching sunset at a beach,a parrot in the shape of a kangaroo watching sunset at a beach,a kangaroo watching sunset at a beach,a parrot watching sunset at a beach]
prompt109	[a kangaroo in the shape of a teddy bear watching sunset at a beach,a teddy bear in the shape of a kangaroo watching sunset at a beach,a kangaroo watching sunset at a beach,a teddy bear watching sunset at a beach]
prompt110	[a kangaroo in the shape of a penguin watching sunset at a beach,a penguin in the shape of a kangaroo watching sunset at a beach,a kangaroo watching sunset at a beach,a penguin watching sunset at a beach]
prompt111	[a cute cat in the shape of a corgi dog watching sunset at a beach,a corgi dog in the shape of a cute cat watching sunset at a beach,a cute cat watching sunset at a beach,a corgi dog watching sunset at a beach]
prompt112	[a cute cat in the shape of a parrot watching sunset at a beach,a parrot in the shape of a cute cat watching sunset at a beach,a cute cat watching sunset at a beach,a parrot watching sunset at a beach]
prompt113	[a cute cat in the shape of a teddy bear watching sunset at a beach,a teddy bear in the shape of a cute cat watching sunset at a beach,a cute cat watching sunset at a beach,a teddy bear watching sunset at a beach]
prompt114	[a cute cat in the shape of a penguin watching sunset at a beach,a penguin in the shape of a cute cat watching sunset at a beach,a cute cat watching sunset at a beach,a penguin watching sunset at a beach]
prompt115	[a corgi dog in the shape of a parrot watching sunset at a beach,a parrot in the shape of a corgi dog watching sunset at a beach,a corgi dog watching sunset at a beach,a parrot watching sunset at a beach]
prompt116	[a corgi dog in the shape of a teddy bear watching sunset at a beach,a teddy bear in the shape of a corgi dog watching sunset at a beach,a corgi dog watching sunset at a beach,a teddy bear watching sunset at a beach]
prompt117	[a corgi dog in the shape of a penguin watching sunset at a beach,a penguin in the shape of a corgi dog watching sunset at a beach,a corgi dog watching sunset at a beach,a penguin watching sunset at a beach]
prompt118	[a parrot in the shape of a teddy bear watching sunset at a beach,a teddy bear in the shape of a parrot watching sunset at a beach,a parrot watching sunset at a beach,a teddy bear watching sunset at a beach]
prompt119	[a parrot in the shape of a penguin watching sunset at a beach,a penguin in the shape of a parrot watching sunset at a beach,a parrot watching sunset at a beach,a penguin watching sunset at a beach]
prompt120	[a teddy bear in the shape of a penguin watching sunset at a beach,a penguin in the shape of a teddy bear watching sunset at a beach,a teddy bear watching sunset at a beach,a penguin watching sunset at a beach]
prompt121	[a kangaroo in the shape of a cute cat admiring the opera house in Sydney,a cute cat in the shape of a kangaroo admiring the opera house in Sydney,a kangaroo admiring the opera house in Sydney,a cute cat admiring the opera house in Sydney]
prompt122	[a kangaroo in the shape of a corgi dog admiring the opera house in Sydney,a corgi dog in the shape of a kangaroo admiring the opera house in Sydney,a kangaroo admiring the opera house in Sydney,a corgi dog admiring the opera house in Sydney]
prompt123	[a kangaroo in the shape of a parrot admiring the opera house in Sydney,a parrot in the shape of a kangaroo admiring the opera house in Sydney,a kangaroo admiring the opera house in Sydney,a parrot admiring the opera house in Sydney]
prompt124	[a kangaroo in the shape of a teddy bear admiring the opera house in Sydney,a teddy bear in the shape of a kangaroo admiring the opera house in Sydney,a kangaroo admiring the opera house in Sydney,a teddy bear admiring the opera house in Sydney]
prompt125	[a kangaroo in the shape of a penguin admiring the opera house in Sydney,a penguin in the shape of a kangaroo admiring the opera house in Sydney,a kangaroo admiring the opera house in Sydney,a penguin admiring the opera house in Sydney]
prompt126	[a cute cat in the shape of a corgi dog admiring the opera house in Sydney,a corgi dog in the shape of a cute cat admiring the opera house in Sydney,a cute cat admiring the opera house in Sydney,a corgi dog admiring the opera house in Sydney]
prompt127	[a cute cat in the shape of a parrot admiring the opera house in Sydney,a parrot in the shape of a cute cat admiring the opera house in Sydney,a cute cat admiring the opera house in Sydney,a parrot admiring the opera house in Sydney]
prompt128	[a cute cat in the shape of a teddy bear admiring the opera house in Sydney,a teddy bear in the shape of a cute cat admiring the opera house in Sydney,a cute cat admiring the opera house in Sydney,a teddy bear admiring the opera house in Sydney]
prompt129	[a cute cat in the shape of a penguin admiring the opera house in Sydney,a penguin in the shape of a cute cat admiring the opera house in Sydney,a cute cat admiring the opera house in Sydney,a penguin admiring the opera house in Sydney]
prompt130	[a corgi dog in the shape of a parrot admiring the opera house in Sydney,a parrot in the shape of a corgi dog admiring the opera house in Sydney,a corgi dog admiring the opera house in Sydney,a parrot admiring the opera house in Sydney]
prompt131	[a corgi dog in the shape of a teddy bear admiring the opera house in Sydney,a teddy bear in the shape of a corgi dog admiring the opera house in Sydney,a corgi dog admiring the opera house in Sydney,a teddy bear admiring the opera house in Sydney]
prompt132	[a corgi dog in the shape of a penguin admiring the opera house in Sydney,a penguin in the shape of a corgi dog admiring the opera house in Sydney,a corgi dog admiring the opera house in Sydney,a penguin admiring the opera house in Sydney]
prompt133	[a parrot in the shape of a teddy bear admiring the opera house in Sydney,a teddy bear in the shape of a parrot admiring the opera house in Sydney,a parrot admiring the opera house in Sydney,a teddy bear admiring the opera house in Sydney]
prompt134	[a parrot in the shape of a penguin admiring the opera house in Sydney,a penguin in the shape of a parrot admiring the opera house in Sydney,a parrot admiring the opera house in Sydney,a penguin admiring the opera house in Sydney]
prompt135	[a teddy bear in the shape of a penguin admiring the opera house in Sydney,a penguin in the shape of a teddy bear admiring the opera house in Sydney,a teddy bear admiring the opera house in Sydney,a penguin admiring the opera house in Sydney]
prompt136	[a kangaroo in the shape of a cute cat sleeping in a cozy bedroom,a cute cat in the shape of a kangaroo sleeping in a cozy bedroom,a kangaroo sleeping in a cozy bedroom,a cute cat sleeping in a cozy bedroom]
prompt137	[a kangaroo in the shape of a corgi dog sleeping in a cozy bedroom,a corgi dog in the shape of a kangaroo sleeping in a cozy bedroom,a kangaroo sleeping in a cozy bedroom,a corgi dog sleeping in a cozy bedroom]
prompt138	[a kangaroo in the shape of a parrot sleeping in a cozy bedroom,a parrot in the shape of a kangaroo sleeping in a cozy bedroom,a kangaroo sleeping in a cozy bedroom,a parrot sleeping in a cozy bedroom]
prompt139	[a kangaroo in the shape of a teddy bear sleeping in a cozy bedroom,a teddy bear in the shape of a kangaroo sleeping in a cozy bedroom,a kangaroo sleeping in a cozy bedroom,a teddy bear sleeping in a cozy bedroom]
prompt140	[a kangaroo in the shape of a penguin sleeping in a cozy bedroom,a penguin in the shape of a kangaroo sleeping in a cozy bedroom,a kangaroo sleeping in a cozy bedroom,a penguin sleeping in a cozy bedroom]
prompt141	[a cute cat in the shape of a corgi dog sleeping in a cozy bedroom,a corgi dog in the shape of a cute cat sleeping in a cozy bedroom,a cute cat sleeping in a cozy bedroom,a corgi dog sleeping in a cozy bedroom]
prompt142	[a cute cat in the shape of a parrot sleeping in a cozy bedroom,a parrot in the shape of a cute cat sleeping in a cozy bedroom,a cute cat sleeping in a cozy bedroom,a parrot sleeping in a cozy bedroom]
prompt143	[a cute cat in the shape of a teddy bear sleeping in a cozy bedroom,a teddy bear in the shape of a cute cat sleeping in a cozy bedroom,a cute cat sleeping in a cozy bedroom,a teddy bear sleeping in a cozy bedroom]
prompt144	[a cute cat in the shape of a penguin sleeping in a cozy bedroom,a penguin in the shape of a cute cat sleeping in a cozy bedroom,a cute cat sleeping in a cozy bedroom,a penguin sleeping in a cozy bedroom]
prompt145	[a corgi dog in the shape of a parrot sleeping in a cozy bedroom,a parrot in the shape of a corgi dog sleeping in a cozy bedroom,a corgi dog sleeping in a cozy bedroom,a parrot sleeping in a cozy bedroom]
prompt146	[a corgi dog in the shape of a teddy bear sleeping in a cozy bedroom,a teddy bear in the shape of a corgi dog sleeping in a cozy bedroom,a corgi dog sleeping in a cozy bedroom,a teddy bear sleeping in a cozy bedroom]
prompt147	[a corgi dog in the shape of a penguin sleeping in a cozy bedroom,a penguin in the shape of a corgi dog sleeping in a cozy bedroom,a corgi dog sleeping in a cozy bedroom,a penguin sleeping in a cozy bedroom]
prompt148	[a parrot in the shape of a teddy bear sleeping in a cozy bedroom,a teddy bear in the shape of a parrot sleeping in a cozy bedroom,a parrot sleeping in a cozy bedroom,a teddy bear sleeping in a cozy bedroom]
prompt149	[a parrot in the shape of a penguin sleeping in a cozy bedroom,a penguin in the shape of a parrot sleeping in a cozy bedroom,a parrot sleeping in a cozy bedroom,a penguin sleeping in a cozy bedroom]
prompt150	[a teddy bear in the shape of a penguin sleeping in a cozy bedroom,a penguin in the shape of a teddy bear sleeping in a cozy bedroom,a teddy bear sleeping in a cozy bedroom,a penguin sleeping in a cozy bedroom]
prompt151	[a kangaroo in the shape of a cute cat admiring a beautiful waterfall in a forest,a cute cat in the shape of a kangaroo admiring a beautiful waterfall in a forest,a kangaroo admiring a beautiful waterfall in a forest,a cute cat admiring a beautiful waterfall in a forest]
prompt152	[a kangaroo in the shape of a corgi dog admiring a beautiful waterfall in a forest,a corgi dog in the shape of a kangaroo admiring a beautiful waterfall in a forest,a kangaroo admiring a beautiful waterfall in a forest,a corgi dog admiring a beautiful waterfall in a forest]
prompt153	[a kangaroo in the shape of a parrot admiring a beautiful waterfall in a forest,a parrot in the shape of a kangaroo admiring a beautiful waterfall in a forest,a kangaroo admiring a beautiful waterfall in a forest,a parrot admiring a beautiful waterfall in a forest]
prompt154	[a kangaroo in the shape of a teddy bear admiring a beautiful waterfall in a forest,a teddy bear in the shape of a kangaroo admiring a beautiful waterfall in a forest,a kangaroo admiring a beautiful waterfall in a forest,a teddy bear admiring a beautiful waterfall in a forest]
prompt155	[a kangaroo in the shape of a penguin admiring a beautiful waterfall in a forest,a penguin in the shape of a kangaroo admiring a beautiful waterfall in a forest,a kangaroo admiring a beautiful waterfall in a forest,a penguin admiring a beautiful waterfall in a forest]
prompt156	[a cute cat in the shape of a corgi dog admiring a beautiful waterfall in a forest,a corgi dog in the shape of a cute cat admiring a beautiful waterfall in a forest,a cute cat admiring a beautiful waterfall in a forest,a corgi dog admiring a beautiful waterfall in a forest]
prompt157	[a cute cat in the shape of a parrot admiring a beautiful waterfall in a forest,a parrot in the shape of a cute cat admiring a beautiful waterfall in a forest,a cute cat admiring a beautiful waterfall in a forest,a parrot admiring a beautiful waterfall in a forest]
prompt158	[a cute cat in the shape of a teddy bear admiring a beautiful waterfall in a forest,a teddy bear in the shape of a cute cat admiring a beautiful waterfall in a forest,a cute cat admiring a beautiful waterfall in a forest,a teddy bear admiring a beautiful waterfall in a forest]
prompt159	[a cute cat in the shape of a penguin admiring a beautiful waterfall in a forest,a penguin in the shape of a cute cat admiring a beautiful waterfall in a forest,a cute cat admiring a beautiful waterfall in a forest,a penguin admiring a beautiful waterfall in a forest]
prompt160	[a corgi dog in the shape of a parrot admiring a beautiful waterfall in a forest,a parrot in the shape of a corgi dog admiring a beautiful waterfall in a forest,a corgi dog admiring a beautiful waterfall in a forest,a parrot admiring a beautiful waterfall in a forest]
prompt161	[a corgi dog in the shape of a teddy bear admiring a beautiful waterfall in a forest,a teddy bear in the shape of a corgi dog admiring a beautiful waterfall in a forest,a corgi dog admiring a beautiful waterfall in a forest,a teddy bear admiring a beautiful waterfall in a forest]
prompt162	[a corgi dog in the shape of a penguin admiring a beautiful waterfall in a forest,a penguin in the shape of a corgi dog admiring a beautiful waterfall in a forest,a corgi dog admiring a beautiful waterfall in a forest,a penguin admiring a beautiful waterfall in a forest]
prompt163	[a parrot in the shape of a teddy bear admiring a beautiful waterfall in a forest,a teddy bear in the shape of a parrot admiring a beautiful waterfall in a forest,a parrot admiring a beautiful waterfall in a forest,a teddy bear admiring a beautiful waterfall in a forest]
prompt164	[a parrot in the shape of a penguin admiring a beautiful waterfall in a forest,a penguin in the shape of a parrot admiring a beautiful waterfall in a forest,a parrot admiring a beautiful waterfall in a forest,a penguin admiring a beautiful waterfall in a forest]
prompt165	[a teddy bear in the shape of a penguin admiring a beautiful waterfall in a forest,a penguin in the shape of a teddy bear admiring a beautiful waterfall in a forest,a teddy bear admiring a beautiful waterfall in a forest,a penguin admiring a beautiful waterfall in a forest]
prompt166	[a kangaroo in the shape of a cute cat walking in a cherry blossom garden,a cute cat in the shape of a kangaroo walking in a cherry blossom garden,a kangaroo walking in a cherry blossom garden,a cute cat walking in a cherry blossom garden]
prompt167	[a kangaroo in the shape of a corgi dog walking in a cherry blossom garden,a corgi dog in the shape of a kangaroo walking in a cherry blossom garden,a kangaroo walking in a cherry blossom garden,a corgi dog walking in a cherry blossom garden]
prompt168	[a kangaroo in the shape of a parrot walking in a cherry blossom garden,a parrot in the shape of a kangaroo walking in a cherry blossom garden,a kangaroo walking in a cherry blossom garden,a parrot walking in a cherry blossom garden]
prompt169	[a kangaroo in the shape of a teddy bear walking in a cherry blossom garden,a teddy bear in the shape of a kangaroo walking in a cherry blossom garden,a kangaroo walking in a cherry blossom garden,a teddy bear walking in a cherry blossom garden]
prompt170	[a kangaroo in the shape of a penguin walking in a cherry blossom garden,a penguin in the shape of a kangaroo walking in a cherry blossom garden,a kangaroo walking in a cherry blossom garden,a penguin walking in a cherry blossom garden]
prompt171	[a cute cat in the shape of a corgi dog walking in a cherry blossom garden,a corgi dog in the shape of a cute cat walking in a cherry blossom garden,a cute cat walking in a cherry blossom garden,a corgi dog walking in a cherry blossom garden]
prompt172	[a cute cat in the shape of a parrot walking in a cherry blossom garden,a parrot in the shape of a cute cat walking in a cherry blossom garden,a cute cat walking in a cherry blossom garden,a parrot walking in a cherry blossom garden]
prompt173	[a cute cat in the shape of a teddy bear walking in a cherry blossom garden,a teddy bear in the shape of a cute cat walking in a cherry blossom garden,a cute cat walking in a cherry blossom garden,a teddy bear walking in a cherry blossom garden]
prompt174	[a cute cat in the shape of a penguin walking in a cherry blossom garden,a penguin in the shape of a cute cat walking in a cherry blossom garden,a cute cat walking in a cherry blossom garden,a penguin walking in a cherry blossom garden]
prompt175	[a corgi dog in the shape of a parrot walking in a cherry blossom garden,a parrot in the shape of a corgi dog walking in a cherry blossom garden,a corgi dog walking in a cherry blossom garden,a parrot walking in a cherry blossom garden]
prompt176	[a corgi dog in the shape of a teddy bear walking in a cherry blossom garden,a teddy bear in the shape of a corgi dog walking in a cherry blossom garden,a corgi dog walking in a cherry blossom garden,a teddy bear walking in a cherry blossom garden]
prompt177	[a corgi dog in the shape of a penguin walking in a cherry blossom garden,a penguin in the shape of a corgi dog walking in a cherry blossom garden,a corgi dog walking in a cherry blossom garden,a penguin walking in a cherry blossom garden]
prompt178	[a parrot in the shape of a teddy bear walking in a cherry blossom garden,a teddy bear in the shape of a parrot walking in a cherry blossom garden,a parrot walking in a cherry blossom garden,a teddy bear walking in a cherry blossom garden]
prompt179	[a parrot in the shape of a penguin walking in a cherry blossom garden,a penguin in the shape of a parrot walking in a cherry blossom garden,a parrot walking in a cherry blossom garden,a penguin walking in a cherry blossom garden]
prompt180	[a teddy bear in the shape of a penguin walking in a cherry blossom garden,a penguin in the shape of a teddy bear walking in a cherry blossom garden,a teddy bear walking in a cherry blossom garden,a penguin walking in a cherry blossom garden]
prompt181	[a kangaroo in the shape of a cute cat walking in a colorful autumn forest,a cute cat in the shape of a kangaroo walking in a colorful autumn forest,a kangaroo walking in a colorful autumn forest,a cute cat walking in a colorful autumn forest]
prompt182	[a kangaroo in the shape of a corgi dog walking in a colorful autumn forest,a corgi dog in the shape of a kangaroo walking in a colorful autumn forest,a kangaroo walking in a colorful autumn forest,a corgi dog walking in a colorful autumn forest]
prompt183	[a kangaroo in the shape of a parrot walking in a colorful autumn forest,a parrot in the shape of a kangaroo walking in a colorful autumn forest,a kangaroo walking in a colorful autumn forest,a parrot walking in a colorful autumn forest]
prompt184	[a kangaroo in the shape of a teddy bear walking in a colorful autumn forest,a teddy bear in the shape of a kangaroo walking in a colorful autumn forest,a kangaroo walking in a colorful autumn forest,a teddy bear walking in a colorful autumn forest]
prompt185	[a kangaroo in the shape of a penguin walking in a colorful autumn forest,a penguin in the shape of a kangaroo walking in a colorful autumn forest,a kangaroo walking in a colorful autumn forest,a penguin walking in a colorful autumn forest]
prompt186	[a cute cat in the shape of a corgi dog walking in a colorful autumn forest,a corgi dog in the shape of a cute cat walking in a colorful autumn forest,a cute cat walking in a colorful autumn forest,a corgi dog walking in a colorful autumn forest]
prompt187	[a cute cat in the shape of a parrot walking in a colorful autumn forest,a parrot in the shape of a cute cat walking in a colorful autumn forest,a cute cat walking in a colorful autumn forest,a parrot walking in a colorful autumn forest]
prompt188	[a cute cat in the shape of a teddy bear walking in a colorful autumn forest,a teddy bear in the shape of a cute cat walking in a colorful autumn forest,a cute cat walking in a colorful autumn forest,a teddy bear walking in a colorful autumn forest]
prompt189	[a cute cat in the shape of a penguin walking in a colorful autumn forest,a penguin in the shape of a cute cat walking in a colorful autumn forest,a cute cat walking in a colorful autumn forest,a penguin walking in a colorful autumn forest]
prompt190	[a corgi dog in the shape of a parrot walking in a colorful autumn forest,a parrot in the shape of a corgi dog walking in a colorful autumn forest,a corgi dog walking in a colorful autumn forest,a parrot walking in a colorful autumn forest]
prompt191	[a corgi dog in the shape of a teddy bear walking in a colorful autumn forest,a teddy bear in the shape of a corgi dog walking in a colorful autumn forest,a corgi dog walking in a colorful autumn forest,a teddy bear walking in a colorful autumn forest]
prompt192	[a corgi dog in the shape of a penguin walking in a colorful autumn forest,a penguin in the shape of a corgi dog walking in a colorful autumn forest,a corgi dog walking in a colorful autumn forest,a penguin walking in a colorful autumn forest]
prompt193	[a parrot in the shape of a teddy bear walking in a colorful autumn forest,a teddy bear in the shape of a parrot walking in a colorful autumn forest,a parrot walking in a colorful autumn forest,a teddy bear walking in a colorful autumn forest]
prompt194	[a parrot in the shape of a penguin walking in a colorful autumn forest,a penguin in the shape of a parrot walking in a colorful autumn forest,a parrot walking in a colorful autumn forest,a penguin walking in a colorful autumn forest]
prompt195	[a teddy bear in the shape of a penguin walking in a colorful autumn forest,a penguin in the shape of a teddy bear walking in a colorful autumn forest,a teddy bear walking in a colorful autumn forest,a penguin walking in a colorful autumn forest]
prompt196	[a kangaroo in the shape of a cute cat flying in the sky at sunset,a cute cat in the shape of a kangaroo flying in the sky at sunset,a kangaroo flying in the sky at sunset,a cute cat flying in the sky at sunset]
prompt197	[a kangaroo in the shape of a corgi dog flying in the sky at sunset,a corgi dog in the shape of a kangaroo flying in the sky at sunset,a kangaroo flying in the sky at sunset,a corgi dog flying in the sky at sunset]
prompt198	[a kangaroo in the shape of a parrot flying in the sky at sunset,a parrot in the shape of a kangaroo flying in the sky at sunset,a kangaroo flying in the sky at sunset,a parrot flying in the sky at sunset]
prompt199	[a kangaroo in the shape of a teddy bear flying in the sky at sunset,a teddy bear in the shape of a kangaroo flying in the sky at sunset,a kangaroo flying in the sky at sunset,a teddy bear flying in the sky at sunset]
prompt200	[a kangaroo in the shape of a penguin flying in the sky at sunset,a penguin in the shape of a kangaroo flying in the sky at sunset,a kangaroo flying in the sky at sunset,a penguin flying in the sky at sunset]
prompt201	[a cute cat in the shape of a corgi dog flying in the sky at sunset,a corgi dog in the shape of a cute cat flying in the sky at sunset,a cute cat flying in the sky at sunset,a corgi dog flying in the sky at sunset]
prompt202	[a cute cat in the shape of a parrot flying in the sky at sunset,a parrot in the shape of a cute cat flying in the sky at sunset,a cute cat flying in the sky at sunset,a parrot flying in the sky at sunset]
prompt203	[a cute cat in the shape of a teddy bear flying in the sky at sunset,a teddy bear in the shape of a cute cat flying in the sky at sunset,a cute cat flying in the sky at sunset,a teddy bear flying in the sky at sunset]
prompt204	[a cute cat in the shape of a penguin flying in the sky at sunset,a penguin in the shape of a cute cat flying in the sky at sunset,a cute cat flying in the sky at sunset,a penguin flying in the sky at sunset]
prompt205	[a corgi dog in the shape of a parrot flying in the sky at sunset,a parrot in the shape of a corgi dog flying in the sky at sunset,a corgi dog flying in the sky at sunset,a parrot flying in the sky at sunset]
prompt206	[a corgi dog in the shape of a teddy bear flying in the sky at sunset,a teddy bear in the shape of a corgi dog flying in the sky at sunset,a corgi dog flying in the sky at sunset,a teddy bear flying in the sky at sunset]
prompt207	[a corgi dog in the shape of a penguin flying in the sky at sunset,a penguin in the shape of a corgi dog flying in the sky at sunset,a corgi dog flying in the sky at sunset,a penguin flying in the sky at sunset]
prompt208	[a parrot in the shape of a teddy bear flying in the sky at sunset,a teddy bear in the shape of a parrot flying in the sky at sunset,a parrot flying in the sky at sunset,a teddy bear flying in the sky at sunset]
prompt209	[a parrot in the shape of a penguin flying in the sky at sunset,a penguin in the shape of a parrot flying in the sky at sunset,a parrot flying in the sky at sunset,a penguin flying in the sky at sunset]
prompt210	[a teddy bear in the shape of a penguin flying in the sky at sunset,a penguin in the shape of a teddy bear flying in the sky at sunset,a teddy bear flying in the sky at sunset,a penguin flying in the sky at sunset]
