prompt1	[a kangaroo walking in Times Square; watching the sunset,a kangaroo watching the sunset; walking in Times Square,a kangaroo walking in Times Square,a kangaroo watching the sunset]
prompt2	[a kangaroo walking in Times Square; in van gogh style,a kangaroo in van gogh style; walking in Times Square,a kangaroo walking in Times Square,a kangaroo in van gogh style]
prompt3	[a kangaroo walking in Times Square; in oil painting style,a kangaroo in oil painting style; walking in Times Square,a kangaroo walking in Times Square,a kangaroo in oil painting style]
prompt4	[a kangaroo walking in Times Square; walking in a tulip garden,a kangaroo walking in a tulip garden; walking in Times Square,a kangaroo walking in Times Square,a kangaroo walking in a tulip garden]
prompt5	[a kangaroo walking in Times Square; watching the northern lights,a kangaroo watching the northern lights; walking in Times Square,a kangaroo walking in Times Square,a kangaroo watching the northern lights]
prompt6	[a kangaroo watching the sunset; in van gogh style,a kangaroo in van gogh style; watching the sunset,a kangaroo watching the sunset,a kangaroo in van gogh style]
prompt7	[a kangaroo watching the sunset; in oil painting style,a kangaroo in oil painting style; watching the sunset,a kangaroo watching the sunset,a kangaroo in oil painting style]
prompt8	[a kangaroo watching the sunset; walking in a tulip garden,a kangaroo walking in a tulip garden; watching the sunset,a kangaroo watching the sunset,a kangaroo walking in a tulip garden]
prompt9	[a kangaroo watching the sunset; watching the northern lights,a kangaroo watching the northern lights; watching the sunset,a kangaroo watching the sunset,a kangaroo watching the northern lights]
prompt10	[a kangaroo in van gogh style; in oil painting style,a kangaroo in oil painting style; in van gogh style,a kangaroo in van gogh style,a kangaroo in oil painting style]
prompt11	[a kangaroo in van gogh style; walking in a tulip garden,a kangaroo walking in a tulip garden; in van gogh style,a kangaroo in van gogh style,a kangaroo walking in a tulip garden]
prompt12	[a kangaroo in van gogh style; watching the northern lights,a kangaroo watching the northern lights; in van gogh style,a kangaroo in van gogh style,a kangaroo watching the northern lights]
prompt13	[a kangaroo in oil painting style; walking in a tulip garden,a kangaroo walking in a tulip garden; in oil painting style,a kangaroo in oil painting style,a kangaroo walking in a tulip garden]
prompt14	[a kangaroo in oil painting style; watching the northern lights,a kangaroo watching the northern lights; in oil painting style,a kangaroo in oil painting style,a kangaroo watching the northern lights]
prompt15	[a kangaroo walking in a tulip garden; watching the northern lights,a kangaroo watching the northern lights; walking in a tulip garden,a kangaroo walking in a tulip garden,a kangaroo watching the northern lights]
prompt16	[a cute cat walking in Times Square; watching the sunset,a cute cat watching the sunset; walking in Times Square,a cute cat walking in Times Square,a cute cat watching the sunset]
prompt17	[a cute cat walking in Times Square; in van gogh style,a cute cat in van gogh style; walking in Times Square,a cute cat walking in Times Square,a cute cat in van gogh style]
prompt18	[a cute cat walking in Times Square; in oil painting style,a cute cat in oil painting style; walking in Times Square,a cute cat walking in Times Square,a cute cat in oil painting style]
prompt19	[a cute cat walking in Times Square; walking in a tulip garden,a cute cat walking in a tulip garden; walking in Times Square,a cute cat walking in Times Square,a cute cat walking in a tulip garden]
prompt20	[a cute cat walking in Times Square; watching the northern lights,a cute cat watching the northern lights; walking in Times Square,a cute cat walking in Times Square,a cute cat watching the northern lights]
prompt21	[a cute cat watching the sunset; in van gogh style,a cute cat in van gogh style; watching the sunset,a cute cat watching the sunset,a cute cat in van gogh style]
prompt22	[a cute cat watching the sunset; in oil painting style,a cute cat in oil painting style; watching the sunset,a cute cat watching the sunset,a cute cat in oil painting style]
prompt23	[a cute cat watching the sunset; walking in a tulip garden,a cute cat walking in a tulip garden; watching the sunset,a cute cat watching the sunset,a cute cat walking in a tulip garden]
prompt24	[a cute cat watching the sunset; watching the northern lights,a cute cat watching the northern lights; watching the sunset,a cute cat watching the sunset,a cute cat watching the northern lights]
prompt25	[a cute cat in van gogh style; in oil painting style,a cute cat in oil painting style; in van gogh style,a cute cat in van gogh style,a cute cat in oil painting style]
prompt26	[a cute cat in van gogh style; walking in a tulip garden,a cute cat walking in a tulip garden; in van gogh style,a cute cat in van gogh style,a cute cat walking in a tulip garden]
prompt27	[a cute cat in van gogh style; watching the northern lights,a cute cat watching the northern lights; in van gogh style,a cute cat in van gogh style,a cute cat watching the northern lights]
prompt28	[a cute cat in oil painting style; walking in a tulip garden,a cute cat walking in a tulip garden; in oil painting style,a cute cat in oil painting style,a cute cat walking in a tulip garden]
prompt29	[a cute cat in oil painting style; watching the northern lights,a cute cat watching the northern lights; in oil painting style,a cute cat in oil painting style,a cute cat watching the northern lights]
prompt30	[a cute cat walking in a tulip garden; watching the northern lights,a cute cat watching the northern lights; walking in a tulip garden,a cute cat walking in a tulip garden,a cute cat watching the northern lights]
prompt31	[a corgi dog walking in Times Square; watching the sunset,a corgi dog watching the sunset; walking in Times Square,a corgi dog walking in Times Square,a corgi dog watching the sunset]
prompt32	[a corgi dog walking in Times Square; in van gogh style,a corgi dog in van gogh style; walking in Times Square,a corgi dog walking in Times Square,a corgi dog in van gogh style]
prompt33	[a corgi dog walking in Times Square; in oil painting style,a corgi dog in oil painting style; walking in Times Square,a corgi dog walking in Times Square,a corgi dog in oil painting style]
prompt34	[a corgi dog walking in Times Square; walking in a tulip garden,a corgi dog walking in a tulip garden; walking in Times Square,a corgi dog walking in Times Square,a corgi dog walking in a tulip garden]
prompt35	[a corgi dog walking in Times Square; watching the northern lights,a corgi dog watching the northern lights; walking in Times Square,a corgi dog walking in Times Square,a corgi dog watching the northern lights]
prompt36	[a corgi dog watching the sunset; in van gogh style,a corgi dog in van gogh style; watching the sunset,a corgi dog watching the sunset,a corgi dog in van gogh style]
prompt37	[a corgi dog watching the sunset; in oil painting style,a corgi dog in oil painting style; watching the sunset,a corgi dog watching the sunset,a corgi dog in oil painting style]
prompt38	[a corgi dog watching the sunset; walking in a tulip garden,a corgi dog walking in a tulip garden; watching the sunset,a corgi dog watching the sunset,a corgi dog walking in a tulip garden]
prompt39	[a corgi dog watching the sunset; watching the northern lights,a corgi dog watching the northern lights; watching the sunset,a corgi dog watching the sunset,a corgi dog watching the northern lights]
prompt40	[a corgi dog in van gogh style; in oil painting style,a corgi dog in oil painting style; in van gogh style,a corgi dog in van gogh style,a corgi dog in oil painting style]
prompt41	[a corgi dog in van gogh style; walking in a tulip garden,a corgi dog walking in a tulip garden; in van gogh style,a corgi dog in van gogh style,a corgi dog walking in a tulip garden]
prompt42	[a corgi dog in van gogh style; watching the northern lights,a corgi dog watching the northern lights; in van gogh style,a corgi dog in van gogh style,a corgi dog watching the northern lights]
prompt43	[a corgi dog in oil painting style; walking in a tulip garden,a corgi dog walking in a tulip garden; in oil painting style,a corgi dog in oil painting style,a corgi dog walking in a tulip garden]
prompt44	[a corgi dog in oil painting style; watching the northern lights,a corgi dog watching the northern lights; in oil painting style,a corgi dog in oil painting style,a corgi dog watching the northern lights]
prompt45	[a corgi dog walking in a tulip garden; watching the northern lights,a corgi dog watching the northern lights; walking in a tulip garden,a corgi dog walking in a tulip garden,a corgi dog watching the northern lights]
prompt46	[a parrot walking in Times Square; watching the sunset,a parrot watching the sunset; walking in Times Square,a parrot walking in Times Square,a parrot watching the sunset]
prompt47	[a parrot walking in Times Square; in van gogh style,a parrot in van gogh style; walking in Times Square,a parrot walking in Times Square,a parrot in van gogh style]
prompt48	[a parrot walking in Times Square; in oil painting style,a parrot in oil painting style; walking in Times Square,a parrot walking in Times Square,a parrot in oil painting style]
prompt49	[a parrot walking in Times Square; walking in a tulip garden,a parrot walking in a tulip garden; walking in Times Square,a parrot walking in Times Square,a parrot walking in a tulip garden]
prompt50	[a parrot walking in Times Square; watching the northern lights,a parrot watching the northern lights; walking in Times Square,a parrot walking in Times Square,a parrot watching the northern lights]
prompt51	[a parrot watching the sunset; in van gogh style,a parrot in van gogh style; watching the sunset,a parrot watching the sunset,a parrot in van gogh style]
prompt52	[a parrot watching the sunset; in oil painting style,a parrot in oil painting style; watching the sunset,a parrot watching the sunset,a parrot in oil painting style]
prompt53	[a parrot watching the sunset; walking in a tulip garden,a parrot walking in a tulip garden; watching the sunset,a parrot watching the sunset,a parrot walking in a tulip garden]
prompt54	[a parrot watching the sunset; watching the northern lights,a parrot watching the northern lights; watching the sunset,a parrot watching the sunset,a parrot watching the northern lights]
prompt55	[a parrot in van gogh style; in oil painting style,a parrot in oil painting style; in van gogh style,a parrot in van gogh style,a parrot in oil painting style]
prompt56	[a parrot in van gogh style; walking in a tulip garden,a parrot walking in a tulip garden; in van gogh style,a parrot in van gogh style,a parrot walking in a tulip garden]
prompt57	[a parrot in van gogh style; watching the northern lights,a parrot watching the northern lights; in van gogh style,a parrot in van gogh style,a parrot watching the northern lights]
prompt58	[a parrot in oil painting style; walking in a tulip garden,a parrot walking in a tulip garden; in oil painting style,a parrot in oil painting style,a parrot walking in a tulip garden]
prompt59	[a parrot in oil painting style; watching the northern lights,a parrot watching the northern lights; in oil painting style,a parrot in oil painting style,a parrot watching the northern lights]
prompt60	[a parrot walking in a tulip garden; watching the northern lights,a parrot watching the northern lights; walking in a tulip garden,a parrot walking in a tulip garden,a parrot watching the northern lights]
prompt61	[a teddy bear walking in Times Square; watching the sunset,a teddy bear watching the sunset; walking in Times Square,a teddy bear walking in Times Square,a teddy bear watching the sunset]
prompt62	[a teddy bear walking in Times Square; in van gogh style,a teddy bear in van gogh style; walking in Times Square,a teddy bear walking in Times Square,a teddy bear in van gogh style]
prompt63	[a teddy bear walking in Times Square; in oil painting style,a teddy bear in oil painting style; walking in Times Square,a teddy bear walking in Times Square,a teddy bear in oil painting style]
prompt64	[a teddy bear walking in Times Square; walking in a tulip garden,a teddy bear walking in a tulip garden; walking in Times Square,a teddy bear walking in Times Square,a teddy bear walking in a tulip garden]
prompt65	[a teddy bear walking in Times Square; watching the northern lights,a teddy bear watching the northern lights; walking in Times Square,a teddy bear walking in Times Square,a teddy bear watching the northern lights]
prompt66	[a teddy bear watching the sunset; in van gogh style,a teddy bear in van gogh style; watching the sunset,a teddy bear watching the sunset,a teddy bear in van gogh style]
prompt67	[a teddy bear watching the sunset; in oil painting style,a teddy bear in oil painting style; watching the sunset,a teddy bear watching the sunset,a teddy bear in oil painting style]
prompt68	[a teddy bear watching the sunset; walking in a tulip garden,a teddy bear walking in a tulip garden; watching the sunset,a teddy bear watching the sunset,a teddy bear walking in a tulip garden]
prompt69	[a teddy bear watching the sunset; watching the northern lights,a teddy bear watching the northern lights; watching the sunset,a teddy bear watching the sunset,a teddy bear watching the northern lights]
prompt70	[a teddy bear in van gogh style; in oil painting style,a teddy bear in oil painting style; in van gogh style,a teddy bear in van gogh style,a teddy bear in oil painting style]
prompt71	[a teddy bear in van gogh style; walking in a tulip garden,a teddy bear walking in a tulip garden; in van gogh style,a teddy bear in van gogh style,a teddy bear walking in a tulip garden]
prompt72	[a teddy bear in van gogh style; watching the northern lights,a teddy bear watching the northern lights; in van gogh style,a teddy bear in van gogh style,a teddy bear watching the northern lights]
prompt73	[a teddy bear in oil painting style; walking in a tulip garden,a teddy bear walking in a tulip garden; in oil painting style,a teddy bear in oil painting style,a teddy bear walking in a tulip garden]
prompt74	[a teddy bear in oil painting style; watching the northern lights,a teddy bear watching the northern lights; in oil painting style,a teddy bear in oil painting style,a teddy bear watching the northern lights]
prompt75	[a teddy bear walking in a tulip garden; watching the northern lights,a teddy bear watching the northern lights; walking in a tulip garden,a teddy bear walking in a tulip garden,a teddy bear watching the northern lights]
prompt76	[a penguin walking in Times Square; watching the sunset,a penguin watching the sunset; walking in Times Square,a penguin walking in Times Square,a penguin watching the sunset]
prompt77	[a penguin walking in Times Square; in van gogh style,a penguin in van gogh style; walking in Times Square,a penguin walking in Times Square,a penguin in van gogh style]
prompt78	[a penguin walking in Times Square; in oil painting style,a penguin in oil painting style; walking in Times Square,a penguin walking in Times Square,a penguin in oil painting style]
prompt79	[a penguin walking in Times Square; walking in a tulip garden,a penguin walking in a tulip garden; walking in Times Square,a penguin walking in Times Square,a penguin walking in a tulip garden]
prompt80	[a penguin walking in Times Square; watching the northern lights,a penguin watching the northern lights; walking in Times Square,a penguin walking in Times Square,a penguin watching the northern lights]
prompt81	[a penguin watching the sunset; in van gogh style,a penguin in van gogh style; watching the sunset,a penguin watching the sunset,a penguin in van gogh style]
prompt82	[a penguin watching the sunset; in oil painting style,a penguin in oil painting style; watching the sunset,a penguin watching the sunset,a penguin in oil painting style]
prompt83	[a penguin watching the sunset; walking in a tulip garden,a penguin walking in a tulip garden; watching the sunset,a penguin watching the sunset,a penguin walking in a tulip garden]
prompt84	[a penguin watching the sunset; watching the northern lights,a penguin watching the northern lights; watching the sunset,a penguin watching the sunset,a penguin watching the northern lights]
prompt85	[a penguin in van gogh style; in oil painting style,a penguin in oil painting style; in van gogh style,a penguin in van gogh style,a penguin in oil painting style]
prompt86	[a penguin in van gogh style; walking in a tulip garden,a penguin walking in a tulip garden; in van gogh style,a penguin in van gogh style,a penguin walking in a tulip garden]
prompt87	[a penguin in van gogh style; watching the northern lights,a penguin watching the northern lights; in van gogh style,a penguin in van gogh style,a penguin watching the northern lights]
prompt88	[a penguin in oil painting style; walking in a tulip garden,a penguin walking in a tulip garden; in oil painting style,a penguin in oil painting style,a penguin walking in a tulip garden]
prompt89	[a penguin in oil painting style; watching the northern lights,a penguin watching the northern lights; in oil painting style,a penguin in oil painting style,a penguin watching the northern lights]
prompt90	[a penguin walking in a tulip garden; watching the northern lights,a penguin watching the northern lights; walking in a tulip garden,a penguin walking in a tulip garden,a penguin watching the northern lights]
